关闭空调啊	关闭空调
开灯呀	开灯
停止吧	停止
打开空调哦	打开空调
停止呢	停止
调低音量啊	调低音量
调低音量吧	调低音量
调高音量嘛	调高音量
关闭空调哈	关闭空调
调低音量哇	调低音量
调低音量哦	调低音量
开灯啊	开灯
停止哇	停止
停止嘛	停止
调高音量吧	调高音量
调低音量吧	调低音量
关灯呢	关灯
开灯吧	开灯
停止吧	停止
关灯哈	关灯
调低音量吧	调低音量
调高音量嘛	调高音量
打开空调哈	打开空调
关闭空调哈	关闭空调
停止哇	停止
关灯嘛	关灯
打开空调哇	打开空调
打开空调呢	打开空调
调高音量哦	调高音量
调高音量哈	调高音量
