关来灯吧	关灯
个调低音量呀	调低音量
关个闭空调哦	关闭空调
关个灯哇	关灯
打给开空调呢	打开空调
点关闭空调嘛	关闭空调
帮打开空调吧	打开空调
停请止哦	停止
调低音下量嘛	调低音量
打来开空调哇	打开空调
帮停止啊	停止
调高音先量哦	调高音量
关闭空快调嘛	关闭空调
调把低音量嘛	调低音量
请停止哦	停止
打把开空调呀	打开空调
打开来空调哦	打开空调
开帮灯哇	开灯
开把灯呀	开灯
关请灯哦	关灯
下关闭空调呀	关闭空调
调低音来量啊	调低音量
打开来空调哈	打开空调
调低先音量啊	调低音量
帮开灯呀	开灯
关下灯哦	关灯
关请灯哈	关灯
停给止嘛	停止
点调高音量嘛	调高音量
调低音点量哦	调低音量
