来关灯	关灯
停帮止	停止
关闭空个调	关闭空调
打下开空调	打开空调
个开灯	开灯
关闭空下调	关闭空调
调低音请量	调低音量
先停止	停止
请停止	停止
点开灯	开灯
调高音先量	调高音量
打请开空调	打开空调
关闭空个调	关闭空调
调低先音量	调低音量
关先灯	关灯
停请止	停止
点关闭空调	关闭空调
快关灯	关灯
打开空把调	打开空调
调低先音量	调低音量
停来止	停止
关闭空点调	关闭空调
调低音请量	调低音量
关下灯	关灯
打开给空调	打开空调
把调低音量	调低音量
点调高音量	调高音量
关闭空给调	关闭空调
个停止	停止
调高请音量	调高音量
